The Haunted Mansion
An Interactive Fiction by Daria Sambar
Release 1 / Serial number 230613 / Inform 7 v10.1.1

Long Hallway
The spooky silence is the first thing you hear when entering. A large amount of dust and cobwebs suggests that no one has set foot here for a long time. The hallway runs from east to west. In the north wall are three doors.

You can see Old showcase (closed) and a porcelain vase here.

>go door 1
Library
Thousands of books line the shelves. An old lamp with a blue lampshade sits on the table. 

You can see Ghost, Bookcase (closed) and a birch table (on which is an old lamp) here.

>ash ghost about who are you
That's not a verb I recognise.

>ask ghost who are you
I didn't understand that sentence.

* * *

>go door 1
Library
Thousands of books line the shelves. An old lamp with a blue lampshade sits on the table. 

You can see Ghost, Bookcase (closed) and a birch table (on which is an old lamp) here.

>ask ghost
What do you want to ask Ghost for?

>ask ghost about
You can ask about: Who are you, What is your name, or What race are you.

>ask ghost about who are you
An ancient warrior in need for a sword!

>tell ghost silver key
I only understood you as far as wanting to tell Ghost.

* * *

>tell ghost promise
I only understood you as far as wanting to tell Ghost.

* * *

>ask ghost
What do you want to ask Ghost for?

>ask ghost who are you
I only understood you as far as wanting to ask Ghost.

>ask ghost about who are you
An ancient warrior in need for a sword!

* * *

>ask ghost about what is your name
My name is Astellan.

>ask ghost what race are you
I only understood you as far as wanting to ask Ghost.

>ask ghost about what race are you
I am a human!

>ask ghost
You can ask about: Who are you, What is your name, or What race are you.

>ask ghost about who are you
An ancient warrior in need for a sword!

>ask ghost about what is your name
My name is Astellan.

>ask ghost about who are you
An ancient warrior in need for a sword!

* * *

>ask ghost who are you
I only understood you as far as wanting to ask Ghost.

* * *

>ask ghost for key
(Ghost first taking Silver key)
Ghost has better things to do.

* * *

>go door 1
Library
Thousands of books line the shelves. An old lamp with a blue lampshade sits on the table. 

You can see Ghost, Bookcase (closed) and a birch table (on which is an old lamp) here.

>ask ghost for notebook
Ghost has better things to do.

>ask ghost for pedant
Ghost has better things to do.

* * *

>go door 1
Library
Thousands of books line the shelves. An old lamp with a blue lampshade sits on the table. 

You can see Ghost, Bookcase (closed) and a birch table (on which is an old lamp) here.

>examine book
You scan the shelves and notice, among others, a volume entitled Secrets of the Kim family.

>examine Secrets of the Kim family
Historical overview of the achievements and troubles of family members kim

>take book
They're hardly portable.

>examine books
You scan the shelves and notice, among others, a volume entitled Secrets of the Kim family.

>examine book
You scan the shelves and notice, among others, a volume entitled Secrets of the Kim family.

* * *

>go door 1
Library
Thousands of books line the shelves. An old lamp with a blue lampshade sits on the table. 

You can see Ghost, Bookcase (closed) and a birch table (on which is an old lamp) here.

>examine books
You scan the shelves and notice, among others, a volume entitled Secrets of the Kim family.

>take books
They're hardly portable.

>take book
They're hardly portable.

>take book Secrets of the Kim family
I only understood you as far as wanting to take the books.

>examine Secrets of the Kim family
Historical overview of the achievements and troubles of family members kim

>examine book
You scan the shelves and notice, among others, a volume entitled Secrets of the Kim family.

>look up
You see nothing unexpected in that direction.

>look up Secrets of the Kim family
Historical overview of the achievements and troubles of family members kim

* * *

>go door 1
Library
Thousands of books line the shelves. An old lamp with a blue lampshade sits on the table. 

You can see Ghost, Bookcase (closed) and a birch table (on which is an old lamp) here.

>take book
They're hardly portable.

* * *

>examine books
You scan the shelves and notice, among others, a volume entitled Secrets of the Kim family.

>examine books
You scan the shelves and notice, among others, a volume entitled Secrets of the Kim family.

>examine Secrets of the Kim family
Historical overview of the achievements and troubles of family members kim

>examine books
You scan the shelves and notice, among others, a volume entitled Secrets of the Kim family.

* * *

>tell ghost about
I only understood you as far as wanting to tell Ghost.

* * *

The Haunted Mansion
An Interactive Fiction by Daria Sambar
Release 1 / Serial number 230613 / Inform 7 v10.1.1

Long Hallway
The spooky silence is the first thing you hear when entering. A large amount of dust and cobwebs suggests that no one has set foot here for a long time. The hallway runs from east to west. In the north wall are three doors.

You can see Old showcase (closed) and a porcelain vase here.

>go door 3
You can't see any such thing.

>go blue door
Art room
Old drawing rack and dried colors are the first thing we see. Numerous paintings are hung on the walls, which are covered with cobwebs and dust.

You can see Erik here.

>ask erik
(for Erik)
(Erik first taking Erik)
Erik has better things to do.

>ask Erik about
You can ask about: Who are you, Can you help me, or What you want.

>ask erik about who are you
Ghost that keep safe this mansion.

>ask erik about can you help me
Only if you give me something in return

>ask erik about what you want
Diamond necklace

>give diamond necklace to erik
You can't see any such thing.

>ask ghost about
You can't see any such thing.

>go s
Long Hallway
The spooky silence is the first thing you hear when entering. A large amount of dust and cobwebs suggests that no one has set foot here for a long time. The hallway runs from east to west. In the north wall are three doors.

You can see Old showcase (closed) and a porcelain vase here.

>go red door
Library
Thousands of books line the shelves. An old lamp with a blue lampshade sits on the table. 

You can see Ghost here.

>ask ghoest about
You can't see any such thing.

* * *

The Haunted Mansion
An Interactive Fiction by Daria Sambar
Release 1 / Serial number 230613 / Inform 7 v10.1.1

Long Hallway
The spooky silence is the first thing you hear when entering. A large amount of dust and cobwebs suggests that no one has set foot here for a long time. The hallway runs from east to west. In the north wall are three doors.

You can see Old showcase (closed) and a porcelain vase here.

>go n
You can go through door 1, door 2, or door 3.

>go door 1
Library
Thousands of books line the shelves. An old lamp with a blue lampshade sits on the table. 

You can see Ghost, Bookcase (closed), a birch table (on which is an old lamp) and Silver key here.

>go s
Long Hallway
The spooky silence is the first thing you hear when entering. A large amount of dust and cobwebs suggests that no one has set foot here for a long time. The hallway runs from east to west. In the north wall are three doors.

You can see Old showcase (closed) here.

>go s
You can't go that way.

>go e
You can't go that way.

* * *

>go door 1
Library
Thousands of books line the shelves. An old lamp with a blue lampshade sits on the table. 

You can see Ghost, Bookcase (closed), a birch table (on which is an old lamp) and Silver key here.

>look at bookcase
You see nothing special about Bookcase.

>open bookcase
It isn't something you can open.

>take book
You can't see any such thing.

>open book
You can't see any such thing.

* * *

>go door 1
Library
Thousands of books line the shelves. An old lamp with a blue lampshade sits on the table. 

You can see Ghost, a birch table (on which is an old lamp) and Silver key here.

* * *

>ask ghost
What do you want to ask Ghost for?

>ask ghost about
I didn't understand that sentence.

>ask ghost about who is she
I can't answer to that question.

>ask ghost who are you
I didn't understand that sentence.

>who are you
That's not a verb I recognise.

>who are you ghost
That's not a verb I recognise.

* * *

>ask ghost about help
I can't answer to that question.

>ask ghost to help you
I didn't understand that sentence.

>ask ghost can you help me
I didn't understand that sentence.

* * *

>go n
You can go through door 1, door 2, or door 3.

>go door1
You can't see any such thing.

>look at door1
You can't see any such thing.

>look at door 1
Faded red color is noticeable at the first door in the hallway.

>go door 1
Darkness
It is pitch dark, and you can't see a thing.

>lit torches
That's not a verb I recognise.

>light torches
You can't see any such thing.

>go s
Long Hallway
The spooky silence is the first thing you hear when entering. A large amount of dust and cobwebs suggests that no one has set foot here for a long time. The hallway runs from east to west. In the north wall are three doors.

You can see Old showcase (closed) here.

>go door 2
Bedroom

>key
That's not a verb I recognise.

>go s
Long Hallway
The spooky silence is the first thing you hear when entering. A large amount of dust and cobwebs suggests that no one has set foot here for a long time. The hallway runs from east to west. In the north wall are three doors.

You can see Old showcase (closed) here.

>unlock door with key
Which do you mean, Door 1, Door 2 or Door 3?

* * *

>go blue door
Art room
Old drawing rack and dried colors are the first thing we see. Numerous paintings are hung on the walls, which are covered with cobwebs and dust.

You can see Erik here.

* * *

The Haunted Mansion
An Interactive Fiction by Daria Sambar
Release 1 / Serial number 230613 / Inform 7 v10.1.1

Long Hallway
The spooky silence is the first thing you hear when entering. A large amount of dust and cobwebs suggests that no one has set foot here for a long time. The hallway runs from east to west. In the north wall are three doors.

You can see Old showcase (closed) and a porcelain vase here.

>go red door
Library
Thousands of books line the shelves. An old lamp with a blue lampshade sits on the table. 

You can see Ghost and Bookcase (closed) here.

>ask ghost about help
Ghost gives you guide to answer your questions.

[Your score has just gone up by five points.]

>open bookcase
Finally!

 You find a silver key.

[Your score has just gone up by five points.]

>go s
Long Hallway
The spooky silence is the first thing you hear when entering. A large amount of dust and cobwebs suggests that no one has set foot here for a long time. The hallway runs from east to west. In the north wall are three doors.

You can see Old showcase (closed) and a porcelain vase here.

>go purple door
Bedroom
Bedroom in gothic style can not go unnoticed when entering. a large bed with bedside tables occupies most of the room. From other furniture you can see a closet and a window through which you can not even see beacuse of dust

You can see Vintage chest of drawers (closed), Wardrobe (closed), Bed (closed) and Bedside table (closed) here.

>open chest
You open Vintage chest of drawers, revealing Old bag.

>take old bag
Taken.

>open old bag
You open Old bag, revealing ten stange pills.

>take strange pill
This will help me.

>eat pill
Oh, that didn't taste right at all, such a bad idea!

[Your score has just gone down by three points.]

>eat pill
(first taking the strange pill)
This will help me.

Oh, that didn't taste right at all, such a bad idea!

[Your score has just gone down by three points.]

>eat pill
(first taking the strange pill)
This will help me.

Oh, that didn't taste right at all, such a bad idea!

[Your score has just gone down by three points.]

>eat pill
(first taking the strange pill)
This will help me.

Oh, that didn't taste right at all, such a bad idea!

    *** You have died! ***

In that game you scored 0 out of a possible 0, in 19 turns.

Would you like to RESTART, RESTORE a saved game, QUIT or UNDO the last command?

* * *

>go red door
Library
Thousands of books line the shelves. An old lamp with a blue lampshade sits on the table. 

You can see Ghost and Bookcase (closed) here.

>look at bookcase
Thousands of books arranged alphabetically are looking for someone to open them

>open bookcase
You open Bookcase, revealing Silver key.

>i
You are carrying nothing.

>take silver key
Taken.

>i
You are carrying:
  Silver key

* * *

>go red door
Library
Thousands of books line the shelves. An old lamp with a blue lampshade sits on the table. 

You can see Ghost and Bookcase (closed) here.

>open bookcase
You first need ask ghost for help.

>ask ghost about help
Ghost gives you guide to answer your questions.

[Your score has just gone up by five points.]

* * *

>open bookcase
Finally!

 You find a silver key.

[Your score has just gone up by five points.]

>i
You are carrying:
  Silver key
  a Guide to Fortune

>read about golden key in guide
A man in the room full of paintings has it.

>read about trasure
You can't see any such thing.

>read about treasure in guide
Somewhere in the mansion you can find a room full of gold.

>read about silver key in guide
Look at the bookcase.

>go s
Long Hallway
The spooky silence is the first thing you hear when entering. A large amount of dust and cobwebs suggests that no one has set foot here for a long time. The hallway runs from east to west. In the north wall are three doors.

You can see Old showcase (closed) and a porcelain vase here.

* * *

>go purple door
Bedroom
Bedroom in gothic style can not go unnoticed when entering. a large bed with bedside tables occupies most of the room. From other furniture you can see a closet and a window through which you can not even see beacuse of dust

You can see Vintage chest of drawers (closed), Wardrobe (closed), Bed (closed) and Bedside table (closed) here.

>open chest
You open Vintage chest of drawers, revealing Four strange pillss.

>take pills
You can't see any such thing.

>i
You are carrying:
  Silver key
  a Guide to Fortune

>take strange pills
I only understood you as far as wanting to take Four strange pillss.

>take strange pills from chest
I only understood you as far as wanting to take Four strange pillss.

>take strange pill from vintage chest of drawers
I only understood you as far as wanting to take Four strange pillss.

* * *

>open bookcase
Finally!

 You find a silver key.

[Your score has just gone up by five points.]

>look at bookcase
Thousands of books arranged alphabetically are looking for someone to open them

>take bookcase
Taken.

>i
You are carrying:
  Bookcase (closed)
  a Guide to Fortune

* * *

>open bookcase
You first need ask ghost for help.

>ask ghost for help
You can't see any such thing.

>ask ghost about help
Ghost gives you guide to answer your questions.

[Your score has just gone up by five points.]

* * *

The Haunted Mansion
An Interactive Fiction by Daria Sambar
Release 1 / Serial number 230613 / Inform 7 v10.1.1

Long Hallway
The spooky silence is the first thing you hear when entering. A large amount of dust and cobwebs suggests that no one has set foot here for a long time. The hallway runs from east to west. In the north wall are three doors.

You can see Old showcase (closed) and a porcelain vase here.

>look at
(Old showcase)
Old showcase with broken glass doors.

>look at door
Which do you mean, Door 1, Door 2 or Door 3?

>look at door 1
Faded red color is noticeable at the first door in the hallway.

>look at door 2
Door of unusual purple color decorated with white flowers.

>look at door 3
The damaged blue door is located at the very end.

* * *

The Haunted Mansion
An Interactive Fiction by Daria Sambar
Release 1 / Serial number 230613 / Inform 7 v10.1.1

Long Hallway
The spooky silence is the first thing you hear when entering. A large amount of dust and cobwebs suggests that no one has set foot here for a long time. The hallway runs from east to west. In the north wall are three doors.

You can see Old showcase (closed) and a porcelain vase here.

>look at showcase
Old showcase with broken glass doors.

>open showcase
You open Old showcase, revealing a locket and Dried fruit.

>i
You are carrying nothing.

* * *

>open showcase
You open Old showcase, revealing a locket and Dried fruit.

>take locket
Taken.

* * *

I beg your pardon?

I beg your pardon?

* * *

>take locket
Taken.

>take fruit
Taken.

>eat fruit
You wish you had another dried fruit.

[Your score has just gone up by ten points.]

>take vase
You weren't careful and you broke the vase.

>go
You'll have to say which compass direction to go in.

>go north
You can go through red door, purple door or blue door.

>go blue door
Art room
Old drawing rack and dried colors are the first thing we see. Numerous paintings are hung on the walls, which are covered with cobwebs and dust. Nothing worth to see here

>go south
Long Hallway
The spooky silence is the first thing you hear when entering. A large amount of dust and cobwebs suggests that no one has set foot here for a long time. The hallway runs from east to west. In the north wall are three doors.

You can see Old showcase (empty) and a broken porcelain vase here.

>go north
You can go through red door, purple door or blue door.

* * *

>go red door
Library
Thousands of books line the shelves. An old lamp with a blue lampshade sits on the table. 

You can see Ghost and Bookcase (closed) here.

* * *

>ask ghost about help
Ghost gives you guide to answer your questions.

[Your score has just gone up by five points.]

>read about treasure in guide
It's not always about a gold. Treasure can be anything.

>i
You are carrying:
  a Guide to Fortune
  a locket (closed and locked)

>open locket
It seems to be locked.

>unlock locket
What do you want to unlock the locket with?

>read about locket key in guide
A man has it.

>read about door key in guide
Look at the bookcase.

>open bookcase
Finally!

 You find a silver key.

[Your score has just gone up by five points.]

>i
You are carrying:
  Silver key
  a Guide to Fortune
  a locket (closed and locked)

>go south
Long Hallway
The spooky silence is the first thing you hear when entering. A large amount of dust and cobwebs suggests that no one has set foot here for a long time. The hallway runs from east to west. In the north wall are three doors.

You can see Old showcase (empty) and a broken porcelain vase here.

* * *

>go north
You can go through red door, purple door or blue door.

>go purple door
Bedroom
Bedroom in gothic style can not go unnoticed when entering. A large bed with bedside tables occupies most of the room. From other furniture you can see a closet and a window through which you can not even see beacuse of dust

You can see Vintage chest of drawers (closed), Wardrobe (closed), Bed (closed), Bedside table (closed) and Erik here.

>open chest
You open Vintage chest of drawers, revealing Old bag.

* * *

>take old bag
Taken.

>look at old bag
You see nothing special about Old bag.

>open old bag
You open Old bag, revealing ten stange pills.

>eat pill
(first taking the strange pill)
Oh, that didn't taste right at all, such a bad idea!

[Your score has just gone down by three points.]

>eat pill
(first taking the strange pill)
Oh, that didn't taste right at all, such a bad idea!

[Your score has just gone down by three points.]

>ask Erik about
You can ask about: Who are you, Can you help me, or What you want.

>ask Erik about who are you
Ghost that keep safe this mansion.

>ask Erik about can you help me
Only if you give me something in return

>ask Erik about what you want
Diamond necklace

>open wardrobe
You open Wardrobe.

>open bed
You open Bed.

>open table
You open Bedside table, revealing Small bag.

>take small  bag
Taken.

>open small bag
Spider was inside and bite you.

[Your score has just gone down by five points.]

>i
You are carrying:
  Small bag (open)
    a diamond necklace
  Old bag (open)
    eight stange pills
  Silver key
  a Guide to Fortune
  a locket (closed and locked)

>give diamond nacklace to erik
You can only do that to something animate.

>give diamond necklace to Erik
(first taking the diamond necklace)
Finally I have it.

 Pills will lead you to answer you seek.

>give Erik a diamond necklace
(first taking the diamond necklace)
That seems to belong to Erik.

>give necklace to Erik
(first taking the diamond necklace)
That seems to belong to Erik.

>eat pill
(first taking the strange pill)
Oh, that didn't taste right at all, such a bad idea!

[Your score has just gone down by three points.]

>eat pills
You can't use multiple objects with that verb.

>eat pill
(first taking the strange pill)
Oh, that didn't taste right at all, such a bad idea!

[Your score has just gone down by three points.]

>wat pill
That's not a verb I recognise.

>eat pill
(first taking the strange pill)
Oh, that didn't taste right at all, such a bad idea!

[Your score has just gone down by three points.]

>eat pil
You can't see any such thing.

>eat pill
(first taking the strange pill)
Oh, that didn't taste right at all, such a bad idea!

[Your score has just gone down by three points.]

>i
You are carrying:
  Small bag (open but empty)
  Old bag (open but empty)
  Silver key
  a Guide to Fortune
  a locket (closed and locked)

>eat pill
You can't see any such thing.

* * *

>take fruit
Taken.

>examine locket
You see nothing special about the locket.

>open locket
It seems to be locked.

>eat fruit
You wish you had another dried fruit.

[Your score has just gone up by ten points.]

>look at vase
You see nothing special about the porcelain vase.

>take vase
You weren't careful and you broke the vase.

>go north
You can go through red door, purple door or blue door.

* * *

>go blue door
Art room
Old drawing rack and dried colors are the first thing we see. Numerous paintings are hung on the walls, which are covered with cobwebs and dust. Nothing worth to see here

* * *

The Haunted Mansion
An Interactive Fiction by Daria Sambar
Release 1 / Serial number 230613 / Inform 7 v10.1.1

Long Hallway
The spooky silence is the first thing you hear when entering. A large amount of dust and cobwebs suggests that no one has set foot here for a long time. The hallway runs from east to west. In the north wall are three doors.

You can see Old showcase (closed) and a porcelain vase here.

>look at showcasr
You can't see any such thing.

* * *

The Haunted Mansion
An Interactive Fiction by Daria Sambar
Release 1 / Serial number 230613 / Inform 7 v10.1.1

Long Hallway
The spooky silence is the first thing you hear when entering. A large amount of dust and cobwebs suggests that no one has set foot here for a long time. The hallway runs from east to west. In the north wall are three doors.

You can see Old showcase (closed) and a porcelain vase here.

>look at wall
There is a lack of color on it.

* * *

The Haunted Mansion
An Interactive Fiction by Daria Sambar
Release 1 / Serial number 230613 / Inform 7 v10.1.1

Long Hallway
The spooky silence is the first thing you hear when entering. A large amount of dust and cobwebs suggests that no one has set foot here for a long time. The hallway runs from east to west. In the north wall are three doors.

You can see Old showcase (closed) and a porcelain vase here.

>open showcase
You open Old showcase, revealing a locket and Dried fruit.

* * *

>take locket
Taken.

>look at locket
You see nothing special about the locket.

>open locket
It seems to be locked.

* * *

>take locket
Taken.

>open locket
It seems to be locked.

>open locket with tiny gold key
You unlock the locket.

>i
You are carrying:
  a locket

* * *

>open locket with tiny gold key
You unlock the locket.

>open locket
You open the locket.

>read locket
You see nothing special about the locket.

* * *

>open locket
It seems to be locked.

>unlock locket
(with the locket)
That doesn't seem to fit the lock.

>open locket
It seems to be locked.

>i
You are carrying:
  a locket

* * *

>unlock locket
What do you want to unlock the locket with?

>unlock locket with tiny gold key
You unlock the locket.

>open locket
You open the locket, revealing Message.

>read message
Behind the pictures with a bowl of fruits are hidden doors.

* * *

>take fruit
Taken.

>i
You are carrying:
  Dried fruit
  a locket (closed and locked)

>look at fruit
Dried fruit packaged in old paper.

>eat fruit
You wish you had another dried fruit.

[Your score has just gone up by ten points.]

* * *

The Haunted Mansion
An Interactive Fiction by Daria Sambar
Release 1 / Serial number 230613 / Inform 7 v10.1.1

Long Hallway
The spooky silence is the first thing you hear when entering. A large amount of dust and cobwebs suggests that no one has set foot here for a long time. The hallway runs from east to west. In the north wall are three doors.

You can see Old showcase (closed) and a porcelain vase here.

>take vase
You shatter the vase.

>attact vase
That's not a verb I recognise.

* * *

The Haunted Mansion
An Interactive Fiction by Daria Sambar
Release 1 / Serial number 230613 / Inform 7 v10.1.1

Long Hallway
The spooky silence is the first thing you hear when entering. A large amount of dust and cobwebs suggests that no one has set foot here for a long time. The hallway runs from east to west. In the north wall are three doors.

You can see Old showcase (closed) and a porcelain vase here.

>x ground
It's rather dirty.

>look at ground
It's rather dirty.

>dirt
That's not a verb I recognise.

>look at dirt
It's rather dirty.